11111111111111111111
1P0000000000000000E1
11101110111011101111
1C0000C0000000C000C1
10111011110111101111
1C0000C0000C0000C001
11111111101111111111
1C000000C0000C0000C1
10111011101110111011
1C0000C0000000C000C1
11111111101111111111
1C0000000C0000000C01
10111011110110111011
1C0000C000C0000C0001
11111111111111111111