111111111111111
1E1C0000C0010C1
100100C0001P001
111111111111111
1000C0000C000C1
100000000000001
111111111111111